1111111111111111111111111111111
1E0000000000000C000000000000001
1010010100100000101010000010101
1010010010101010010010000010101
1P0000000C00C000000000000000AC1
1111111111111111111111111111111
